Saifee Brothers	
FOundation Bolt, Sponge, Nut Bolts, G.I.Wire, Chain, Hole Pass, Amit But Hinges, Chetak Screw,	Suh Brand Panal Pin, Nails, Kangaroo Brand Riffing Nails, S.S. & Iron Hardware Fittings	
GSTIN: 23ACJPH2535C1Z7	1, Jawahar Marg, (Behind Union Bank), Siyaganj, Indore 452007 (M.P.), Mob.: 99260 41406	
TAX INVOICE Original Tax Recipents	
Duplicate for Supplier/Transporter	
Invoice No. 442	Details of Receiver / Billed to:	
Name	
Address: AAabi wASAAO AOna QAo	
invoice Date	Place of Supply:on sn Stato :	State Code:	
esTIN No. : K ARSPna2a0LAZ3.	
Transport:	
Vehicle No.	
Name of Products	HSN	Qty.	Amount	
C Code	Rate	S.	
PS.	
&32 lopa	
Cartage	
Total co	
Words	
Bank: Union Bank of India	Total Amount before Tax	
No. : 326201010037321	Add: CGST	
Add: SGST	
:UBIN 0532622	
Add : IGST	
be paid of reverse chargge	Total Amount After Tax	
M	
ject to Indore Jurisdiction.	
Return, No Exchange.	
0.E.	
For Stfee-Rrothe rs	
Pronrieinr TOorisa	
