T.Ebrahim & Sons	
OUnda tion Bolt, Nut Bolts, U.Bolt, Full Thread Rod, Pipe, Jook, Wire AnCho,	
Fasther & Harware Fittings	
CSyaganj Main Road, Tijori Gali Corner, Indore-452 007 (M.P.) Mob. : 91796 23336	
GSTIN: 23EDEPK9125D1ZT	TAX INVOICEOginal Tax Recipents	
Duplicate for Supplier/Transporter	
invoice No. :24763	Details of Receiver ( Billed to	
Name	
Address: Neseah AO	
Invoice Date	Place of Supply: Se State (A.state Code:	
oSTIN NG,3A Pu12oLZ3	
Transport	Vehicle No. :	
Sr.	
No	Name of Products	HSN	Qty.	Rate	Amount	
Code	Rs.	Ps.	
00	
Cartage	
Total	
n Words	Total Amount before Tax	
ar Bank: Dena Bank, Siyaganj Branch	Add: CGSST	
c. No. : 018011023911	Add: SGST	
C: BKDNO810180	Add: IGST	
to be paid of reverse charge	Total Amount After Tax	
erest (@24% will be charged if payment not made on due date	
ods once sold will not be taken back.	
bject to lndore Jurisdiction.	For T.Ebrahim & Sons	
0.E.	
