T.Ebrahim & Sons	
Foundation Bolt, Nut Bolts, U.Boit, Full Thread Rod, Pipe, Jook, Wire Anchor,	
Fastner & Harware Fittings	
84, Siyaganj Main Road, Tijori Gali Corner, Indore-452 007 (M.P.) Mob.: 91796 23336	
GSTIN: 23EDEPK9125D1ZT	TAX INVOICE	Original Tax Recipents	
Duplicate for Supplier/Transporter	
Details of Receiver	
Invoice No. :	2476	Name:	or m	v	
Address: eon ab wMoJ wo	
Place of Supply: sshs	StateA	stato Code:	
Invoice Date :	asTIN No. 3ARS	2Ao	2&	
Transport:	Vehicle No.	
Sr.	HSN	Amount	
Name of Products	Qty.	Rate	Rs.	PS.	
NO	Code	
Cartage	
Total	
Total Amount before Tax	
Add: CGST|	
Rs. in Words	
Our Bank: Dena Bank, Siyaganj Branch	Add: SGST	
A/c. No. : 018011023911	Add: IGSST	
IFSC: BKDNO810180	Total Amount After Tax	
Tax to be paid of reverse eharge	
Interest (@24% will be charged if payment not made on due date.	Goods once sold will not be taken back.	For:T.Ebrahim & Sons	
Subject to Indore Jurisdiction.	
E.&O.E.	
