GST iNVOiCE	
Foundation Bolt, Sponge, Nut Bolts, G.IWire, Chain, Hole Pas	un Brand Panal Pin, Nails, Kangaroo Brand Riffing Nalls,	Saifee Brothers	.l.VWire, Chain, Hole Pass, Amit But Hinge	
GSTIN: 23ACJPH2535C1Z7	471, Jawahar Marg, (Behind Union Bank), Siyaganj, Indore 452u	Indore 452007 (M.P.), Mob. : 260 41408	Nails, S.S. & Iron Hardware Fittings	nges, Chetak Screw,	
Invoice No.:	36	TAX INVOICEOriginal Tax Recipe nts	
Name	Details of Re√ßeiver 3ed	Duplieate for Suppliori Transporte	
to:	
Addresss	
invoice Date:	
Flace of Supply:	
stato	
GSTIN No.:	statoe Code :	
Transport:	AR n 23SLA2K	
Sr.	
No	Vehicle No.:	
Name of Products	
HSN	
Amount	
Code	Qty.	Rate	
Rs.	Ps.	
31 Isk	
Cartag	
Tpta	
Bank: Un ion Bank of India	al Amouht before Vdx	
No. : 326201010037321	Add: CGST	
Add: SGST	
: UBIN 0532622	
Add IGST	
be paid of reverse charge	Total Amount After Tax Jle	
ject to Indore Jurisdiction.	
Return, No Exchange.	
O.E.	For Saifee yrothers	
