Saifeee Brothers	
Oundation Bolt, Sponge, Nut Bolts, G.J.Wire, Chain, Hole Pass, Amit But Hinges, Chetak sCrew,	un Brand Panal Pin, Nails, Kangaroo Brand Riffing Nails, S.S. & Iron Hardware Fiangs	
GSTIN: 23ACJPH2535C127	Jawahar Marg. (Behind Union Bank), Siyaganj, Indore 452007 (M.P.), Mob. : 99260 41408	
TAX INVOICE Original Tax Reciponts	
Duplicato for SuppliorlTransporter	
Invoice No.	Details of Re√ßeiver / Billed to :	Name:	
365	
Address AADAA	
Invoice Date	Place of Supply:	awetate MaState Code	
Salwha	GSTIN No. : RR SIA H24oL17	
Transport:	
Vehicle No.:	
S	
N	Name of Products	HSN	
Qty.	Amount	
Code	Rate	
Rs.	Ps.	
Cartag	
Tota 1R-	
. in Wordsw d	rnolkon!	
ar Bank : Union Bank of Ind ia	Toal Amouht before V	
. No. : 326201010037321	Add: Add: CGST	
C: UBIN 0532622	Add :SGST	
Add: 1GST	
to be paid of reverse charge	
Total Amourit After Tax	
ubject to Indore Jurisdiction.	
o Return, No Exchange.	
&0.E.	
ForSaifee Dyredhers	
Ciare na mis invoice shows the actual price of the goods	
ed and that all particulars are true and cnrrert	
